0
---
FFFFFFFFFFFFFFFMMMMMMMMMMMMMMMMMMMMMMMMMMM
FGGFGFGFGGGGGGGMMMMMMMSSSSSMMMMMMSSSSMMMMM
FGGFGGGFGFGGGGGGMMMMMSSSSSSSMMMMSSSSSSMMMM
FGFFGFGFGFGGFGGGGMSSSSSSSSSSSSSSSSSSSSSSMM
FGGGGFGFGFGGFGGGGMSMMSSSSSSSMMMMSSSSSSMMMM
FGFFGFGFGFGFFFGGGMSMMMSSSSSMMMMWMSSSSMWMMM
FGFFGFGGGFGGGGGGGMSMMMMMMMMMMMMWMMMMMMWMMM
FGFFFFGFFFGGGGGGGMSMMMMMMMMMMMMWMMMMMMWMGM
FGGFGGGGGFGGWGGGGMSSSSSSSSSSSMMWMMMMMMWMGM
FFFFGFFFGGGWWWGGGMSMMMMMSMMMSMMWMMMMMMWMGM
FGGFGGGGGGWWWWWGGMMMFFFMMMFFFFFWGGMMGGWGGM
FGGFGGFGGGGWWWGGGGGGGGGGGGGGGGWWWWWWWWWGGM
FGGFGGFGGGGGWGGGGGGGGGGGGGGGGGWGGFGGGGGFGM
FGGFGGFGGGGGGGGGGFFFGGGFFFFGGGWGGGGGGFGFGM
FGGGGGGGGGGGGGGGGGGGGGGGGGGGGGWGFGFGFFGFGM
FGFFFFFGFFFGGGGGGGGGGGGGGGGGGGWGGGGGGGGGGM
FGGGGGGGGGGGGGGGGWWWWWWWWWWGGGGGMMMMMMMMMM
FGGGGGGGGWGGFGFGGWGGGGGGGGWGGGWGMSSSSSSSSM
FGFGGFGGGWGGGGGGGWGFGGGGFGWWWWWGMSMSSMSSSM
FGFGGFGGGWGGFGFGGGGGGGGGGGWGGGGGMSMMMMMMMM
FGFGGFGGGWGGGGGGGWGGGGGGGGWGGGMGMSSSSSSSSM
FGFGGFGGGWGFFFFGGWGFGGGGFGGGGGMGMSMMMMSMMM
FGGGGGGGGWGGGGGGGWGGGGGGGGWGMGMGMSSSSSSSSM
FGGGGGGGGGGFFFFGGWWWWGGWWWWGMGMGMMMSSMMMMM
FFFFFFFGGFFFFFFFFFGGGGGGGGWGMGMGGGGGGGGGGM
FFFFFFGGFFFFFGFFFFFGFFFGGGWGMGGGGGGGGGGGGM
FGFGFGGGFFFFGGGFFFFGFFFGGGWGMGGGMMMMMMMMMM
MGGGFGGGFFFGGGGGFFFGGGGGGGWGGGGGGGGMGGGGGM
MGGGFGGGFFFFGGGFFFFGFGGGGGWGGGGGGGGMGGGGGM
MGGGGGGGGFFFFGFFFFGGFGGGGGWWWGWWWWGMGMMMMM
MGGGGGGGGGGGGGGGGGGGGGGGGGGGGGGGGWGGGGGGGM
MMMMMMMMMGGGGMMMMMMMGGMMMMGGGGGGGWMMMMMMGM
MSSSSSSSMGGGGMGGGGGGGGGGGMGGGGGGGWMMMMMMMM
MSMMSSSSMGGGGMGGGGGGGGFGGMGGWWWWWWWWMMWWMM
MSMMSSSSMGGGGMGFGGWWGGFGGMGGWWMWWWWWMMWWMM
MSSSSSSSMGGMGMGGGGWWGGFGGMGGWWWWMMWWMMWWMM
MSSSSSSSMGGMGGGGGGGGGGGGGMGGWWWWMMWWMMWWMM
MSSSSSSMMMMMGGFGGGGGFFFGGMGGWWWWWWWWMMWWMM
MSSSSSSSSMMMGGFGWWWGGFGGGMGGWWWWWWWWMMWWMM
MSSSSSSSSMMMGGFGGGGGGFGGGMGGWWWWWWWWWWWWMM
MSSSSSSSSSGGGGGGGGGGGGGGGMMMWWWWWWWWWWWWMM
MMMMMMMMMMMMMMMMMMMMMMMMMMMMMMMMMMMMMMMMMM
---
5 32 0->14 26 1
39 17 0->13 25 2
24 1 0->14 25 3
